Subject	Subject performing the test
ActivityLabel	Activity Label Friendly Name
Activity	Activity ID
tBodyAcc.mean...X	Mean of tBodyAcc.mean...X Observation
tBodyAcc.mean...Y	Mean of tBodyAcc.mean...Y Observation
tBodyAcc.mean...Z	Mean of tBodyAcc.mean...Z Observation
tBodyAcc.std...X	Mean of tBodyAcc.std...X Observation
tBodyAcc.std...Y	Mean of tBodyAcc.std...Y Observation
tBodyAcc.std...Z	Mean of tBodyAcc.std...Z Observation
tGravityAcc.mean...X	Mean of tGravityAcc.mean...X Observation
tGravityAcc.mean...Y	Mean of tGravityAcc.mean...Y Observation
tGravityAcc.mean...Z	Mean of tGravityAcc.mean...Z Observation
tGravityAcc.std...X	Mean of tGravityAcc.std...X Observation
tGravityAcc.std...Y	Mean of tGravityAcc.std...Y Observation
tGravityAcc.std...Z	Mean of tGravityAcc.std...Z Observation
tBodyAccJerk.mean...X	Mean of tBodyAccJerk.mean...X Observation
tBodyAccJerk.mean...Y	Mean of tBodyAccJerk.mean...Y Observation
tBodyAccJerk.mean...Z	Mean of tBodyAccJerk.mean...Z Observation
tBodyAccJerk.std...X	Mean of tBodyAccJerk.std...X Observation
tBodyAccJerk.std...Y	Mean of tBodyAccJerk.std...Y Observation
tBodyAccJerk.std...Z	Mean of tBodyAccJerk.std...Z Observation
tBodyGyro.mean...X	Mean of tBodyGyro.mean...X Observation
tBodyGyro.mean...Y	Mean of tBodyGyro.mean...Y Observation
tBodyGyro.mean...Z	Mean of tBodyGyro.mean...Z Observation
tBodyGyro.std...X	Mean of tBodyGyro.std...X Observation
tBodyGyro.std...Y	Mean of tBodyGyro.std...Y Observation
tBodyGyro.std...Z	Mean of tBodyGyro.std...Z Observation
tBodyGyroJerk.mean...X	Mean of tBodyGyroJerk.mean...X Observation
tBodyGyroJerk.mean...Y	Mean of tBodyGyroJerk.mean...Y Observation
tBodyGyroJerk.mean...Z	Mean of tBodyGyroJerk.mean...Z Observation
tBodyGyroJerk.std...X	Mean of tBodyGyroJerk.std...X Observation
tBodyGyroJerk.std...Y	Mean of tBodyGyroJerk.std...Y Observation
tBodyGyroJerk.std...Z	Mean of tBodyGyroJerk.std...Z Observation
tBodyAccMag.mean..	Mean of tBodyAccMag.mean.. Observation
tBodyAccMag.std..	Mean of tBodyAccMag.std.. Observation
tGravityAccMag.mean..	Mean of tGravityAccMag.mean.. Observation
tGravityAccMag.std..	Mean of tGravityAccMag.std.. Observation
tBodyAccJerkMag.mean..	Mean of tBodyAccJerkMag.mean.. Observation
tBodyAccJerkMag.std..	Mean of tBodyAccJerkMag.std.. Observation
tBodyGyroMag.mean..	Mean of tBodyGyroMag.mean.. Observation
tBodyGyroMag.std..	Mean of tBodyGyroMag.std.. Observation
tBodyGyroJerkMag.mean..	Mean of tBodyGyroJerkMag.mean.. Observation
tBodyGyroJerkMag.std..	Mean of tBodyGyroJerkMag.std.. Observation
fBodyAcc.mean...X	Mean of fBodyAcc.mean...X Observation
fBodyAcc.mean...Y	Mean of fBodyAcc.mean...Y Observation
fBodyAcc.mean...Z	Mean of fBodyAcc.mean...Z Observation
fBodyAcc.std...X	Mean of fBodyAcc.std...X Observation
fBodyAcc.std...Y	Mean of fBodyAcc.std...Y Observation
fBodyAcc.std...Z	Mean of fBodyAcc.std...Z Observation
fBodyAcc.meanFreq...X	Mean of fBodyAcc.meanFreq...X Observation
fBodyAcc.meanFreq...Y	Mean of fBodyAcc.meanFreq...Y Observation
fBodyAcc.meanFreq...Z	Mean of fBodyAcc.meanFreq...Z Observation
fBodyAccJerk.mean...X	Mean of fBodyAccJerk.mean...X Observation
fBodyAccJerk.mean...Y	Mean of fBodyAccJerk.mean...Y Observation
fBodyAccJerk.mean...Z	Mean of fBodyAccJerk.mean...Z Observation
fBodyAccJerk.std...X	Mean of fBodyAccJerk.std...X Observation
fBodyAccJerk.std...Y	Mean of fBodyAccJerk.std...Y Observation
fBodyAccJerk.std...Z	Mean of fBodyAccJerk.std...Z Observation
fBodyAccJerk.meanFreq...X	Mean of fBodyAccJerk.meanFreq...X Observation
fBodyAccJerk.meanFreq...Y	Mean of fBodyAccJerk.meanFreq...Y Observation
fBodyAccJerk.meanFreq...Z	Mean of fBodyAccJerk.meanFreq...Z Observation
fBodyGyro.mean...X	Mean of fBodyGyro.mean...X Observation
fBodyGyro.mean...Y	Mean of fBodyGyro.mean...Y Observation
fBodyGyro.mean...Z	Mean of fBodyGyro.mean...Z Observation
fBodyGyro.std...X	Mean of fBodyGyro.std...X Observation
fBodyGyro.std...Y	Mean of fBodyGyro.std...Y Observation
fBodyGyro.std...Z	Mean of fBodyGyro.std...Z Observation
fBodyGyro.meanFreq...X	Mean of fBodyGyro.meanFreq...X Observation
fBodyGyro.meanFreq...Y	Mean of fBodyGyro.meanFreq...Y Observation
fBodyGyro.meanFreq...Z	Mean of fBodyGyro.meanFreq...Z Observation
fBodyAccMag.mean..	Mean of fBodyAccMag.mean.. Observation
fBodyAccMag.std..	Mean of fBodyAccMag.std.. Observation
fBodyAccMag.meanFreq..	Mean of fBodyAccMag.meanFreq.. Observation
fBodyBodyAccJerkMag.mean..	Mean of fBodyBodyAccJerkMag.mean.. Observation
fBodyBodyAccJerkMag.std..	Mean of fBodyBodyAccJerkMag.std.. Observation
fBodyBodyAccJerkMag.meanFreq..	Mean of fBodyBodyAccJerkMag.meanFreq.. Observation
fBodyBodyGyroMag.mean..	Mean of fBodyBodyGyroMag.mean.. Observation
fBodyBodyGyroMag.std..	Mean of fBodyBodyGyroMag.std.. Observation
fBodyBodyGyroMag.meanFreq..	Mean of fBodyBodyGyroMag.meanFreq.. Observation
fBodyBodyGyroJerkMag.mean..	Mean of fBodyBodyGyroJerkMag.mean.. Observation
fBodyBodyGyroJerkMag.std..	Mean of fBodyBodyGyroJerkMag.std.. Observation
fBodyBodyGyroJerkMag.meanFreq..	Mean of fBodyBodyGyroJerkMag.meanFreq.. Observation
